#######
O     #
# #####
#     #
# #####
#     G
#######