#######
O #   #
# # # #
#   # #
# ### #
# #   G
#######