#######
O    ##
# #####
# #   #
#   # #
# # # G
#######