###########################
O #     #####  ### # ## ###
#   ###  ##### ### # ## ###
# ######           #      #
#  ##### ## ######## ## # #
##   ##  ##          ## # #
####  ######### ####### # G
###########################
